11111111111111111
1EC00000001CC0001
1111C100000100C01
1P0001C0010000001
11111111111111111