1111111111111
1E000000000C1
1011000001111
1011011100001
1P0101C001001
1011111111111
1111111111111