1111111111111111111
10000000000000000E1
1000000000000000001
1000000000000000001
1P00000000000000001
10000000000000000C1
1111111111111111111