11111111111111111
1EC00000001CC0001
1111C100000100C01
1P0001C0010000001
10000000000001001
1000000000000C101
11111111111111111