1111111111111
1E000000000C1
1011000001101
1100011111101
1C1001C00P001
1111111111111