1111111111111
1E00000000001
1011000001101
1000011110001
1P00010000001
1111111111111
