1111111111101
1E000000000C0
1011000001101
1000011110001
1P0001C000001
1111111111111