1111111111111
1E000000000C1
1011000001101
1000011110001
1P0001C000001
1111111111011