1111111111111
1E000000000C1
1001000001101
1111011100001
1P0101C001001
1111111111111